                                                                                                                                
                                                                                                                                
                                                                                                                                
                                                                *-----------------------*            *---------------------*    
                                                                |                       |            |                     |    
                                                                |                       |            |                     |    
     *---------------------*                                    |                       |            |                     |    
     |                     |                                    |                       |            |                     |    
     |                     |                                    |                       |            |                     |    
     |                     |                                    *-----------------------*            *---------------------*    
     |                     |                                              |  |                                |  |              
     |                     |                                              |  |                                |  |              
     *---------------------*                                              |  |                                |  |              
              |  |                                                        |  |                                |  |              
              |  |                                                        |  |                                |  |              
              |  |                                                        |  |                                |  |              
              |  |                                                        |  |                                |  |              
              |  |                                                        |  |                                |  |              
              |  |                                                        |  |                                |  |              
              |  |                                                        |  |                                |  |              
              |  |                                               *---------------------*                      |  |              
     *---------------------*                                     |                     |             *---------------------*    
     |                     |                                     |                     |             |                     |    
     |                     |                                     |                     |             |                     |    
     |                     |                                     |                     |             |                     |    
     |                     |                                     |                     |             |                     |    
     |                     |                                     *---------------------*             |                     |    
     *---------------------*                                                                         *---------------------*    
                                                                                                                                
                                                                                                                                
                                                                                                                                
                                                                                                                                
