                                                                                                                                
                                                                                                                                
                                                                                                                                
                                    ┌─────────────────────────────┐                                   ┌─────────────────────┐   
                                    │                             │                                   │                     │   
                             ───────│                             │                                   │                     │   
      ┌─────────────────────┐       │                             │                                   │                     │   
      │                     │───────│                             │───────────────────────────────────│                     │   
      │                     │       │                             │                                   │                     │   
      │                     │       └─────────────────────────────┘───────────────────────────────────│                     │   
      │                     │                         │ │                                             │                     │   
      │                     │                         │ │                                             │                     │   
      └─────────────────────┘                         │ │                                             │                     │   
                │ │                                   │ │                                             └─────────────────────┘   
                │ │                                   │ │                                                       │ │             
                │ │                                   │ │                                                       │ │             
                │ │                                   │ │                                                       │ │             
                │ │                                   │ │                                                       │ │             
                │ │                                   │ │                                                       │ │             
                │ │                                   │ │                                                       │ │             
                │ │                         ┌─────────────────────┐                                             │ │             
      ┌─────────────────────┐               │                     │                                   ┌─────────────────────┐   
      │                     │               │                     │                                   │                     │   
      │                     │───────────────│                     │───────────────────────────────────│                     │   
      │                     │               │                     │                                   │                     │   
      │                     │───────────────│                     │───────────────────────────────────│                     │   
      │                     │               │                     │                                   │                     │   
      └─────────────────────┘               │                     │                                   └─────────────────────┘   
                                            └─────────────────────┘                                                             
                                                                                                                                
                                                                                                                                
                                                                                                                                
